                                                        
                                                        
                                                        
                                                        
                                                        
                                                        ####################################
                                                        ## M                              ##
                                                        ##  ####    ########    ######    ##
                                                        ##  ##      ##    ##    ##        ##
                                                        ##  ##      ##    ##    ######    ##
                                                        ##          ##          ##        ##
                                                        ######      ##    ########        ##
                                                        ##          ##          ##        ##
                                                        ##  ######  ########    ######    ##
                                                        ##                              B ##
                                                        ####################################