
    ############################################################################################################################################################################################################################################################
    ##   M  ##      ##              ##                      ##              ##                      ##              ##                              ##                              ##                                      ##              ##                ##
    ##      ##      ##########      ##      ##      ##########      ##      ##      ##      ##########      ##########      ##      ##################      ##################      ##########################      ##########      ##      ##      ##        ##  
    ##      ##                              ##      ##              ##              ##      ##              ##              ##      ##                      ##              ##                              ##              ##      ##              ##        ##
    ##      ##      ##########      ##################      ##################################      ##########################      ##      ##################      ##      ##########################      ##########      ##      ##################        ##
    ##      ##              ##                                              ##              ##                              ##      ##                      ##      ##      ##              ##      ##              ##      ##      ##                        ##
    ##      ##      ##########      ##################      ##      ##      ##      ##      ##########################      ##      ##################      ##      ##      ##      ##      ##      ##################      ##      ##      ####################
    ##              ##              ##              ##      ##      ##              ##                                      ##              ##              ##      ##              ##              ##                      ##      ##      ##                ##
    ##################      ##########      ##      ##      ##      ##########################################################      ##########      ##########      ##########################      ##      ##################      ##      ##      ##        ##
    ##                      ##              ##              ##      ##              ##                              ##              ##              ##                      ##                      ##      ##                      ##      ##      ##        ##
    ##      ##################      ##########      ##################      ##      ##      ##################      ##      ##########      ##########################      ##########################      ##      ##########################      ##        ##                              
    ##              ##              ##                              ##      ##              ##              ##              ##              ##              ##              ##                              ##              ##                      ##        ##
    ##########      ##      ##########      ##################      ##      ##################      ##      ##########      ##      ##################      ##      ##########      ##########      ##################      ##      ##################        ##
    ##              ##      ##      ##              ##      ##                                      ##              ##      ##      ##                      ##      ##              ##                                      ##              ##                ##
    ##      ##################      ##########      ##      ##########      ##################################      ##      ##      ##########      ##########      ##      ##########      ##################      ##################      ##      ############
    ##              ##              ##              ##              ##      ##                              ##      ##      ##      ##              ##                              ##                      ##                              ##                ##
    ##########      ##      ##########      ##########      ##########      ##      ##################      ##      ##########      ##      ##################################      ##################      ##################      ##################        ##                             
    ##              ##              ##                      ##              ##                      ##      ##                      ##      ##                      ##      ##              ##              ##              ##      ##              ##        ##
    ##      ##################      ##########################      ##########################      ##      ##########################      ##      ##########      ##      ##########      ##      ##########      ##########      ##      ##      ##        ##                     
    ##                              ##                                              ##              ##      ##              ##                      ##              ##              ##      ##                      ##                      ##      ##        ##
    ##################################      ##################      ##########      ##      ##########      ##      ##      ##########################      ##########      ##########      ##########################      ##################      ############              
    ##                                      ##                      ##      ##      ##              ##              ##                              ##                                      ##      ##              ##      ##              ##                ##
    ##      ##################################      ##########      ##      ##      ##########      ##########################################      ##################      ##########      ##      ##      ##      ##      ##      ##      ##########        ##                
    ##      ##                                      ##              ##              ##      ##      ##              ##                      ##                              ##              ##              ##              ##      ##              ##        ##
    ##      ##      ##################################      ##########      ##########      ##      ##      ##      ##      ##      ##################      ##################      ##########      ##########      ##########      ##      ##########        ##                                    
    ##      ##                                              ##              ##              ##      ##      ##              ##      ##                      ##                      ##              ##              ##              ##      ##                ##
    ##      ##################################################      ##########      ##      ##      ##      ##      ##################      ##################      ##################      ##################      ##      ####################################
    ##                              ##                                      ##      ##      ##      ##      ##      ##                      ##              ##      ##                      ##              ##              ##                                ##
    ##################      ##########      ##########################      ##########      ##      ##      ##########      ##      ##########      ##########      ##      ##################      ##      ##########      ##      ##################        ##                                
    ##              ##      ##              ##                      ##              ##              ##                      ##              ##                      ##      ##                      ##              ##      ##      ##                        ##
    ##      ##################      ##########      ##########################      ##################      ##########      ##########      ##########################      ##      ##########################      ##      ##      ##      ####################                 
    ##      ##                      ##      ##                              ##                              ##                      ##      ##                              ##                      ##                      ##      ##                        ##
    ##      ##      ##################      ##########################      ##      ##################      ##      ##################      ##      ##########################################      ##      ##      ##################################        ##
    ##              ##                      ##              ##              ##      ##                      ##      ##                      ##      ##                      ##                      ##      ##                              ##                ##
    ##      ##########      ##################      ##      ##      ##########      ##      ##########################      ##################      ##################      ##########################      ##      ##########      ##      ##      ############
    ##      ##              ##                      ##              ##              ##              ##                      ##              ##                              ##                              ##      ##      ##      ##      ##                ##
    ##      ##      ##########      ##################################      ##################      ##      ##################      ##      ##################################      ##########################      ##      ##      ##################        ##      
    ##########      ##              ##                              ##      ##                      ##      ##                      ##                                              ##                              ##      ##              ##                ##
    ##              ##      ##########      ##################      ##      ##################################      ##################################################################      ##########################      ##      ##      ##      ############
    ##              ##                      ##              ##              ##                                      ##                                              ##              ##      ##                              ##      ##               B        ##
    ##      ##################################      ##      ##################      ##################################      ##########################################      ##      ##      ##      ##########################      ##########      ##        ##
    ##                                              ##                              ##                                                                                      ##              ##                                              ##      ## FINISH ##
    ############################################################################################################################################################################################################################################################